subtitle:
囗 : enclosure  
囚 : prisoner  
四 : four  
囙 : rare variant of cause  
囡 : little girl  
回 : return  
囝 : son (dialectal)  
因 : cause, reason  
囤 : stockpile  
困 : trapped, distressed  
囫 : incomplete, crushed  
囧 : archaic "bright"; emoji-like face  
囮 : decoy, puppet (archaic)  
囯 : variant of country  
囬 : variant of return  
囲 : Japanese "surround"  
园 : simplified garden  
囹 : prison  
固 : firm, solid  
囷 : granary  
图 : simplified map, diagram  
囿 : enclosed park  
圃 : nursery garden  
圂 : pigsty  
圄 : jail  
圇 : literary "entire"  
國 : traditional country  
圈 : circle, enclose  
圊 : literary toilet  
圉 : animal stable  
圌 : rare hill  
圍 : traditional surround  
園 : traditional garden  
圓 : traditional round  
圖 : traditional map  
團 : traditional group  
圜 : literary round  
圛 : rare, used in names  

